##..S..#
.###.#.#
...#.#.#
##...#.#
####.#.#
#..###.#
##.....#
##.###.#
##G#####