#################################################################################
S.....#...#.............#...#...#...#.........#...........#.......#...#.....#...#
#.#.###.#.#####.###.#####.#.###.#.#.#########.###########.#.#####.#.###.#.#.#.#.#
#.#...#.#.....#.#.#.#.....#.....#.#.#...#...#.#...........#.#.....#.#...#.#.#.#.#
#.###.#.#####.#.#.#.#.#############.#.#.###.#.#.###########.#.#.###.#.###.#.###.#
#.#...#.#.....#...#.#.#.......#...#.#.#.....#.#.#...........#.#.#...#...#.#...#.#
###.###.#.#########.#.#.#####.#.#.#.#.#####.#.#.#.###########.#.###.###.#.###.#.#
#...#...#.#...#...#.#...#...#.#.#.#...#.....#.#.#.........#.#.#.#...#...#...#.#.#
#.###.###.#.#.#.#.#.#####.#.#.#.#.###.###.###.#.#########.#.#.#.#.###.#####.#.#.#
#.....#.#.#.#.#.#...#.....#.#.#.#...#...#.#...#.#.........#...#.#.....#...#.#.#.#
#######.#.###.###.#####.###.#.#.###.###.#.#.#.#.#.#######.#####.#######.#.#.#.#.#
#...#...#...#...#.#...#.#...#.#...#.#.#.#...#...#.#.........#...#.......#...#...#
#.#.#.#####.###.#.#.#.#.#.###.#####.#.#.#.#######.###.#####.#.###.#######.###.###
#.#...#.........#.#.#...#...........#.#.#.#...#.....#...#...#...#.......#...#...#
#.###.#.#.#.#####.#.#########.#######.#.###.#.#####.###.#######.#######.###.###.#
#...#...#.#.......#.....#...#.......#.#.#...#...#.#.#...#.....#.......#...#...#.#
#########.#####.###.###.#.#.#######.#.#.#.#####.#.#.#.###.###.###########.###.###
#.......#...#.#...#.#.....#...#.......#...#.......#.#...#.#.......#.....#...#...#
#.###.#####.#.###.#.#.#######.#.###########.#####.#.#####.#.#######.###.###.###.#
#.#.#.......#.#...#.#.....#...#.....#.....#.#.....#.....#.#.........#...#...#...#
#.#.#####.###.#.###########.#######.#.#.#.#.#.#########.#.#############.#.#####.#
#...#...#.#.#.#.#.................#.#.#.#.#.#.......#...#.#.............#.#...#.#
#.###.#.#.#.#.#.#.###############.#.###.#.#.#######.#.#.#.#.###############.#.#.#
#...#.#...#.#.#...#.....#...#.....#.....#.....#...#...#...#.#.......#.......#...#
###.#.#####.#.#####.#####.#.###############.#.#.#.#.#######.#.#####.#.###########
#.#.#.....#...#...#.......#...#.......#.#...#.#.#.#...#.....#.....#.#.....#.....#
#.#.###.#.#.#####.###########.#.#####.#.#.###.#.#.###.#.###########.#####.#.#.#.#
#...#...#...#...#.#...........#.#...#.#...#...#.#...#.#.#...........#.....#.#.#.#
#####.#######.#.#.#.#####.#####.#.###.#####.#######.###.#.###########.#####.#.#.#
#.#...#...#...#...#.#.....#...#.#.....#...#.....#.#.....#.#...#.....#...#.#.#.#.#
#.#.###.#.###.#.###.#.#####.#.#.#######.#.#####.#.#######.#.#.#.###.#.#.#.#.#.###
#.#.#...#...#.#.#...#.#.....#.#...#...#.#.....#.#.#...#...#.#.#...#.#.#.#...#...#
#.#.#######.#.###.#####.#####.###.###.#.###.#.#.#.#.#.#.###.#.###.#.###.#.#####.#
#.#.....#...#...#.#.....#...#...#.#...#.#.#.#...#.#.#...#...#...#.#.....#.....#.#
#.#####.#.#####.#.#######.#####.#.#.###.#.#.#####.#.#####.#######.###########.#.#
#.#.......#...#.#...#...#.#.........#.....#...#...#...#...#.....#.#...........#.#
#.#.###.###.#.#.###.#.#.#.#.#####.###.#########.#####.#.###.###.#.#.###########.#
#...#...#...#...#...#.#.#.#.....#.#...#...#...#...#.....#.#...#.#...#.....#.#...#
#.###.###.###.###.#####.#.#####.#.#.#####.#.#.###.###.###.###.#.#.###.###.#.#.###
#.#...#...#.#.#...#.....#.....#.#.#.#.......#.#.......#.....#.#...#.#.#...#...#.#
###.###.#.#.#.#.###.###.###.#.#.#.#.#.###.###.###.#########.#.#####.#.#.###.#.#.#
#...#...#.#...#.#...#.....#.#.#.#.#.#.#.#.#.#...#.......#.#.#.....#.#.#...#.#.#.#
#.###.#########.#####.###.#.###.#.#.#.#.#.#.#.#.#######.#.#.#####.#.#.#.#.###.#.#
#.............#.#...#.#...#.....#.#...#.#...#.#.....#...#.......#.#...#.#.......#
#.###.#######.#.#.#.#.#.#########.#####.###########.#.#####.###.#.#####.#####.#.#
#...#.#...#.#.#.#.#...#.......#...#...#.#.#.......#...#.......#.#...#.#.#.#...#.#
#####.#.#.#.#.#.#.#####.#######.###.#.#.#.#.#####.#############.###.#.#.#.#.###.#
#.....#.#...#...#.....#...#.....#...#.#.....#.....#...#...#.........#...#...#.#.#
#.#####.###.#######.#.###.#.#######.#########.#.#.#.#.#.#.#.#################.#.#
#.#...#.#...#.....#.#.#...#.#.......#...#.....#.#.#.#.#.#...#.....#.....#...#...#
#.#.#.#.#.#.#.###.#.#.#.###.#.#######.#.#.#####.###.#.#.#####.#.###.###.#.#.#.###
#...#.#.#.#.#.#...#.#.#...#.#.....#...#.#.....#...#.#.#...#...#.....#.#...#.#...#
#####.#.#.#.###.#####.#####.#####.#####.###.#####.#.#.###.#.#.#######.#####.###.#
#...#...#.#.....#.....#...#.....#.....#...#.#...#...#.#.#.#.#.....#.#.#.....#...#
#.#.#####.#######.#.###.#.#####.#.###.#.#.#.#.#.#####.#.#.#.#####.#.#.#.#####.###
#.#.#.#...........#...#.#.#.#...#...#.#.#.#.#.#.......#.#.#.....#...#...#...#...#
#.#.#.#.#.###########.#.#.#.#.#####.#.###.#.#.###.#####.#.#######.###.#.#.#####.#
#.#.#...#.#.......#...#.#.#.#.......#...#.#.#...#.#.......#.........#.#...#.....#
###.#.###.#.#####.###.###.#.#####.#.###.#.#.###.#.#.###.###.#######.#######.#####
#...#.#...#.#...#...#.#...#.#...#.#...#.#.#.#...#...#...#...#.#...#.#.....#.....#
#.###.#.###.###.###.###.###.#.###.#####.#.###.#######.###.###.#.#.###.###.#####.#
#.#...#.#.#...#.#.#...#.#...#.....#...#.#.#...#.......#...#.#...#...#...#.......#
#.#.###.#.###.#.#.###.#.#.#########.#.#.#.#.###.#######.###.#.#####.###.#.#######
#.#...#.#...#.....#...#...#.......#.#.....#...#.............#...#.#.....#.......#
#.#.#.#.###.###.###.###.###.#.#####.###.###.#.#################.#.#############.#
#.#.#.#...#...#...#...#.#...#.......#...#...#.#.....#...........#.#...........#.#
#.###.###.#.#.#######.#.#.###########.###.###.#.###.#.###########.#.#########.#.#
#...#.#...#.#.#...#.#.....#...#.......#...#...#.#.#.......#.....#.#.....#...#...#
###.#.#.#####.#.#.#.###.#####.#.#######.###.###.#.#########.###.#.#####.###.#####
#.#...#.#.....#.#...#...#.....#...#...#...#...#...#.........#...#...#.#.#...#...#
#.#####.#.#####.###.###.#.#######.#.#.###.###.#####.#########.#####.#.#.#.###.#.#
#.........#...#.#...#...#.....#.#...#.....#...#...#...#.....#.............#...#.#
#.#######.#.#.#.#####.#####.#.#.###########.###.#.###.#.###.###########.###.###.#
#...#...#.#.#.#...#.#.#...#.#.#.....#.....#.#...#.#...#...#.#.........#.#...#...#
###.#.#.###.#.###.#.#.#.#.#.#.#.###.#.###.#.#####.###.###.#.###.#####.#.#.###.#.#
#...#.#.#...#.#...#...#.#.#.#.#.#...#...#...#.....#...#.#.#.....#...#.#...#...#.#
#.###.#.#.#.###.###.###.#.###.#.#######.#####.#####.###.#.#######.#.#.#####.#####
#.....#.#.#.....#.......#...#.#.#.....#...#...#...#.#...#.#.....#.#...#.#...#...#
#######.#.#.#####.#########.#.#.#.###.#.#.#.#####.#.#.#.#.#.###.#.#.###.#.###.#.#
#.........#.......#...........#.....#...#.........#...#...#...#...#.....#.....#.G
#################################################################################